1111111111111111111111111111
1E0000000000000C00000C000001
1010010100100000101001000001
1P10010010101010001001000001
100000000C00C0000000000000C1
1111111111111111111111111111
